EEEEEEEEEHIGHESCOREEEEEEEEEE
EEEEE00EEEEEEEEEEEEEEEEEEEEE
EEEEEEEEEEEEEEEEEEEEEEEEEEEE
WWWWWWWWWWWWWWWWWWWWWWWWWWWW
WPPPPPPPPPPPPWWPPPPPPPPPPPPW
WPWWWWPWWWWWPWWPWWWWWPWWWWPW
WSWWWWPWWWWWPWWPWWWWWPWWWWSW
WPWWWWPWWWWWPWWPWWWWWPWWWWPW
WPPPPPPPPPPPPPPPPPPPPPPPPPPW
WPWWWWPWWPWWWWWWWWPWWPWWWWPW
WPWWWWPWWPWWWWWWWWPWWPWWWWPW
WPPPPPPWWPPPPWWPPPPWWPPPPPPW
WWWWWWPWWWWWEWWEWWWWWPWWWWWW
EEEEEWPWWWWWEWWEWWWWWPWEEEEE
EEEEEWPWWEEEEGEEEEEWWPWEEEEE
EEEEEWPWWEWWWDDWWWEWWPWEEEEE
WWWWWWPWWEWEEEEEEWEWWPWWWWWW
TTTTTTPEEEWGEEGEGWEEEPTTTTTT
WWWWWWPWWEWEEEEEEWEWWPWWWWWW
EEEEEWPWWEWWWWWWWWEWWPWEEEEE
EEEEEWPWWEEEEEEEEEEWWPWEEEEE
EEEEEWPWWEWWWWWWWWEWWPWEEEEE
WWWWWWPWWEWWWWWWWWEWWPWWWWWW
WPPPPPPPPPPPPWWPPPPPPPPPPPPW
WPWWWWPWWWWWPWWPWWWWWPWWWWPW
WPWWWWPWWWWWPWWPWWWWWPWWWWPW
WSPPWWPPPPPPPMEPPPPPPPWWPPSW
WWWPWWPWWPWWWWWWWWPWWPWWPWWW
WWWPWWPWWPWWWWWWWWPWWPWWPWWW
WPPPPPPWWPPPPWWPPPPWWPPPPPPW
WPWWWWWWWWWWPWWPWWWWWWWWWWPW
WPWWWWWWWWWWPWWPWWWWWWWWWWPW
WPPPPPPPPPPPPPPPPPPPPPPPPPPW
WWWWWWWWWWWWWWWWWWWWWWWWWWWW
EEEEEEEEEEEEEEEEEEEEEEEEEEEE
EEEEEEEEEEEEEEEEEEEEEEEEEEEE
