{
    "wall": {
        "A": {"x": 16, "y": 3},
        "B": {"x": 17, "y": 3},
        "C": {"x": 18, "y": 3},
        "D": {"x": 19, "y": 3},
        "E": {"x": 20, "y": 3},    
        "F": {"x": 16, "y": 4},
        "G": {"x": 20, "y": 4},
        
        "H": {"x": 29, "y": 3},
        "I": {"x": 30, "y": 3},
        
        "J": {"x": 16, "y": 5},
        "K": {"x": 17, "y": 5},
        "L": {"x": 20, "y": 5},

        "M": {"x": 29, "y": 4},
        "N": {"x": 30, "y": 4},
        
        "O": {"x": 27, "y": 3},
        "P": {"x": 28, "y": 3},

        "Q": {"x": 27, "y": 4},
        "R": {"x": 28, "y": 4},
        
        "a": {"x": 24, "y": 3},
        "b": {"x": 25, "y": 3},
        "c": {"x": 26, "y": 3},
        "d": {"x": 24, "y": 5},
        "e": {"x": 25, "y": 5},
        "f": {"x": 26, "y": 5},
        "g": {"x": 24, "y": 4},
        "h": {"x": 26, "y": 4},
        "i": {"x": 21, "y": 3},
        "j": {"x": 23, "y": 3},
        "k": {"x": 21, "y": 5},
        "l": {"x": 23, "y": 5},

        "m": {"x": 16, "y": 6},
        "n": {"x": 17, "y": 6},
        "o": {"x": 18, "y": 6},
        "p": {"x": 19, "y": 6},

        "q": {"x": 31, "y": 3},
        "r": {"x": 31, "y": 4},
        "s": {"x": 31, "y": 5}
    }

}
